1111111111111111111
1000000000000001111
1P011E00000C0000001
1000000000000000001
1001C00000000001111
1111111111111111111